,Surface,Player,Count_Win,Count_Lose,total_play,perc_win
396,Clay,Nadal R.,351,35,386,90.93
135,Clay,Djokovic N.,169,39,208,81.25
165,Clay,Federer R.,203,60,263,77.19
304,Clay,Kuerten G.,105,40,145,72.41
169,Clay,Ferrero J.C.,221,86,307,71.99
405,Clay,Nishikori K.,60,24,84,71.43
550,Clay,Thiem D.,59,24,83,71.08
100,Clay,Coria G.,129,53,182,70.88
168,Clay,Ferrer D.,293,122,415,70.6
389,Clay,Moya C.,203,85,288,70.49
